1111111111111111111
1022222222222222201
1211111110111111121
1200100010100010021
1210101010101010121
1210101010101010121
1210101011101010121
1210001000001000121
2211111111111111122
1022222222222222201
1211111011101111121
1210000010100000121
1211111010101111121
1210000002000000121
1211111010101111121
1210000010100000121
1211111011101111121
1022222222222222201
1111111111111111111
