1111111111111111111
1000000001000000001
1011011101011101101
1000000000000000001
1111010111110101111
1111010001000101111
1111011121211101111
1111012222222101111
2200022111112200022
1111012222222101111
1111012111112101111
1000000001000000001
1011011101011101101
1001000002000001001
1101010111110101011
1000010001000100001
1011111101011111101
1000000000000000001
1111111111111111111