1111111111111111111
1000000000000000001
1011011111111101101
1011000000000001101
1011011111111101101
1011000000000001101
1001011111111101001
1101012222222101011
2222222111112222222
1101012222222101011
1001011111111101001
1011000000000001101
1011011111111101101
1011010002000101101
1000000111110000001
1011010000000101101
1011011111111101101
1000000000000000001
1111111111111111111
